¤═════════════════[┼]═════════════════¤
║...................................__║
║__................................[()║
║()]...............................[()║
║()]..................................║
║.....................................║
║.....................................║
¦.....................................¦
¦.....................................¦
¦.....................................¦
║¤]...................................║
║¤].....................┌───────┐┬┬┬┬┬║
║¤].....................└───────┘¯¯¯¯¯¦
║.................................()..¦
║.................................()..║
¤═════════════════════════════════════¤