▒▒▒▒▒▒▒▒▒▒▒▒▒▒▒▒▒▒▒▒▒▒▒▒▒▒▒▒▒▒▒▒▒▒▒▒▒▒▒
┬┬┬┬┬┬┬┬┬┬┬┬┬┬┬┬┬┬┬┬┬┬┬┬┬┬┬┬┬┬┬┬┬┬┬┬┬┬┬
=======================================
...............................()......
...()..................................
.......................................
........................().............
.......................................
┼.....................................┼
.......................................
.......................................
.......................................
..¤═══════════════[┼]═══════════════¤..
..║---------------\ /---------------║..
..║---------------/ \---------------║..
..¤═════════════════════════════════¤..